####################################################
##**************************************************
##**************************************************
##**************************************************
##******************^*******************************
##*****************<#*******************************
##*****************<#********_***<_*****************
##*@********#**************_******************___***
##________#_#_#_________________#____________****#**
####################################################