#######################################
##*************************************
##*************************************
##*************************************
##*************^***********************
##************<#**********_*^**********
##************<#********_***#**********
##@****#**************_*****#**********
##___#_#_#__________________#__________
#######################################