#######################################
##*************************************
##*************************************
##*************************************
##*************^***********************
##************<#**********_*^**********
##*******#****<#********_***#**********
##@****#*#*_**********_*****#**********
##___#_#_#__________________#__________
#######################################