##########################################################################
##******************************************#*#*#*************************
##******************************************#*#*#*************************
##******************************************#*#*#*************************
##******************************************#*#*#*************************
##******************************************#*#***************************
##**************************_***************#***#*_***********************
##************************_*******************#*#**_**********************
##*@*******************************__^******#*#*#***_*********************
##########################################################################