#######################################
##*************************************
##*************************************
##*************************************
##*************^***********************
##************<#**********_**^*********
##*******#****<#********_****#*********
##@****#*#*_**********_******#*********
##___#_#_#___________________#_________
#######################################