##*************************************
##*************************************
##*************************************
##*************************************
##*************^***********************
##************<#***********************
##*******#****<#***********************
##@****#*#*_***************************
##___#_#_#_____________________________
#######################################